ja	en
ja	en	predict
サイト	site
リーダー	leader
コーチ	coach
ソーシャル	social
ニッケル	nickel
サスペンス	suspense
コラージュ	collage
セラ	sera
ギルダー	guilder
ムニ	muni
ブロス	bros
ニップル	nipple
クラッド	clad
モノアミン	monoamine
キングリー	ingly
ダーマ	derma
チョーク	choke
ズッパ	zuppa
シューバ	shuba
モノポール	monopole
リュージュ	luge
クレンブテロール	clenbuterol
ドライポイント	drypoint
ブラバ	brava
アダプティブ	adoptive
アリスター	alister
カリフ	calif
クライブ	clive
クラッシュ	crash
デール	daile
ディム	dim
フライアー	flyer
フロイド	freud
ハース	hearth
ハイディ	heidi
ヒストリック	historic
ジュピター	jupiter
カイリー	kylie
ラーナー	larner
ナポリ	napoli
フォビア	phobia
プロザック	prozac
レーザー	raiser
ループ	roop
